#domain
hospital
#levelname
debug6
#colors
blue: 5, 4, B, 6
red: 1, 3, A, 0, 2
green: C, 7
lightblue: 8, D
#initial
+++++++++++++++++++++++++
+                       +
+A A A A A A A A A A C B+
+                       +
+B +++6+++++++ +  +C    +
+ +   +   +   D  C+ +B  +
+3+ +   +   +   +8 2+7+5+
++  +++++++++++++++++++++
++ +   +   +   +        +
+  + + + + + + + ++++++ +
+ ++ + + + + + + +1 +4+ +
+    +   +   +   +  +   +
+++++++++++++++++++ + +++
+0                 B    +
+                       +
+A A A A A A A A A A B B+
+                       +
+++++++++++++++++++++++++
#goal
+++++++++++++++++++++++++
+A A A A A A A A A A C B+
+                       +
+                       +
+  +++ +++++++D+  +     +
+ +   +   +       + +   +
+ + +   +   +   +   + + +
++  +++++++++++++++++++++
++ +   +   +   +        +
+  + + + + + + + ++++++ +
+ ++ + + + + + + +  + + +
+    +   +   +   +  +   +
+++++++++++++++++++ + +++
+                       +
+                       +
+                       +
+A A A A A A A A A A B B+
+++++++++++++++++++++++++
#end
