#domain
hospital
#levelname
debug2
#colors
red: 0
#initial
++++++++++++
+       0+ +
+ ++ +++++ +
+          +
+ ++ +++++ +
+ +        +
++++++++++++
#goal
++++++++++++
+       0+ +
+ ++ +++++ +
+          +
+ ++ +++++ +
+ +        +
++++++++++++
#end
