#domain
hospital
#levelname
TeamLARM
#colors
blue: 0, A
grey: Z
#initial
+++++++++++
+    0    +
++++   ++++
+ZZZ   ++++
+A Z   +A +
+  Z A +  +
+++++++++++
#goal
+++++++++++
+         +
++++   ++++
+      ++++
+      +  +
+    0 +  +
+++++++++++
#end